/home/jorik/sites/api-test-platform-code/media/newman
/	django.contrib.flatpages.views.flatpage	home
/__debug__/history_refresh/	debug_toolbar.panels.history.views.history_refresh	djdt:history_refresh
/__debug__/history_sidebar/	debug_toolbar.panels.history.views.history_sidebar	djdt:history_sidebar
/__debug__/render_panel/	debug_toolbar.views.render_panel	djdt:render_panel
/__debug__/sql_explain/	debug_toolbar.panels.sql.views.sql_explain	djdt:sql_explain
/__debug__/sql_profile/	debug_toolbar.panels.sql.views.sql_profile	djdt:sql_profile
/__debug__/sql_select/	debug_toolbar.panels.sql.views.sql_select	djdt:sql_select
/__debug__/template_source/	debug_toolbar.panels.templates.views.template_source	djdt:template_source
/accounts/activate/<activation_key>/	registration.backends.default.views.ActivationView	registration_activate
/accounts/activate/complete/	django.views.generic.base.TemplateView	registration_activation_complete
/accounts/activate/resend/	registration.backends.default.views.ResendActivationView	registration_resend_activation
/accounts/login/	django.contrib.auth.views.LoginView	auth_login
/accounts/logout/	django.contrib.auth.views.LogoutView	auth_logout
/accounts/password/change/	django.contrib.auth.views.PasswordChangeView	auth_password_change
/accounts/password/change/done/	django.contrib.auth.views.PasswordChangeDoneView	auth_password_change_done
/accounts/password/reset/	django.contrib.auth.views.PasswordResetView	auth_password_reset
/accounts/password/reset/	django.contrib.auth.views.PasswordResetView	auth_password_reset
/accounts/password/reset/complete/	django.contrib.auth.views.PasswordResetCompleteView	auth_password_reset_complete
/accounts/password/reset/confirm/<uidb64>/<token>/	django.contrib.auth.views.PasswordResetConfirmView	auth_password_reset_confirm
/accounts/password/reset/done/	django.contrib.auth.views.PasswordResetDoneView	auth_password_reset_done
/accounts/register/	registration.backends.default.views.RegistrationView	registration_register
/accounts/register/closed/	django.views.generic.base.TemplateView	registration_disallowed
/accounts/register/complete/	django.views.generic.base.TemplateView	registration_complete
/admin/	django.contrib.admin.sites.index	admin:index
/admin/<app_label>/	django.contrib.admin.sites.app_index	admin:app_list
/admin/accounts/user/	django.contrib.admin.options.changelist_view	admin:accounts_user_changelist
/admin/accounts/user/<id>/password/	django.contrib.auth.admin.user_change_password	admin:auth_user_password_change
/admin/accounts/user/<path:object_id>/	django.views.generic.base.RedirectView
/admin/accounts/user/<path:object_id>/change/	django.contrib.admin.options.change_view	admin:accounts_user_change
/admin/accounts/user/<path:object_id>/delete/	django.contrib.admin.options.delete_view	admin:accounts_user_delete
/admin/accounts/user/<path:object_id>/history/	django.contrib.admin.options.history_view	admin:accounts_user_history
/admin/accounts/user/add/	django.contrib.auth.admin.add_view	admin:accounts_user_add
/admin/accounts/user/autocomplete/	django.contrib.admin.options.autocomplete_view	admin:accounts_user_autocomplete
/admin/admin_index/appgroup/	ordered_model.admin.changelist_view	admin:admin_index_appgroup_changelist
/admin/admin_index/appgroup/<path:object_id>/	django.views.generic.base.RedirectView
/admin/admin_index/appgroup/<path:object_id>/change/	django.contrib.admin.options.change_view	admin:admin_index_appgroup_change
/admin/admin_index/appgroup/<path:object_id>/delete/	django.contrib.admin.options.delete_view	admin:admin_index_appgroup_delete
/admin/admin_index/appgroup/<path:object_id>/history/	django.contrib.admin.options.history_view	admin:admin_index_appgroup_history
/admin/admin_index/appgroup/<path:object_id>/move-<direction>/	ordered_model.admin.move_view	admin:admin_index_appgroup_change_order
/admin/admin_index/appgroup/add/	django.contrib.admin.options.add_view	admin:admin_index_appgroup_add
/admin/admin_index/appgroup/autocomplete/	django.contrib.admin.options.autocomplete_view	admin:admin_index_appgroup_autocomplete
/admin/api_authentication/customtoken/	django.contrib.admin.options.changelist_view	admin:api_authentication_customtoken_changelist
/admin/api_authentication/customtoken/<path:object_id>/	django.views.generic.base.RedirectView
/admin/api_authentication/customtoken/<path:object_id>/change/	django.contrib.admin.options.change_view	admin:api_authentication_customtoken_change
/admin/api_authentication/customtoken/<path:object_id>/delete/	django.contrib.admin.options.delete_view	admin:api_authentication_customtoken_delete
/admin/api_authentication/customtoken/<path:object_id>/history/	django.contrib.admin.options.history_view	admin:api_authentication_customtoken_history
/admin/api_authentication/customtoken/add/	django.contrib.admin.options.add_view	admin:api_authentication_customtoken_add
/admin/api_authentication/customtoken/autocomplete/	django.contrib.admin.options.autocomplete_view	admin:api_authentication_customtoken_autocomplete
/admin/auth/group/	django.contrib.admin.options.changelist_view	admin:auth_group_changelist
/admin/auth/group/<path:object_id>/	django.views.generic.base.RedirectView
/admin/auth/group/<path:object_id>/change/	django.contrib.admin.options.change_view	admin:auth_group_change
/admin/auth/group/<path:object_id>/delete/	django.contrib.admin.options.delete_view	admin:auth_group_delete
/admin/auth/group/<path:object_id>/history/	django.contrib.admin.options.history_view	admin:auth_group_history
/admin/auth/group/add/	django.contrib.admin.options.add_view	admin:auth_group_add
/admin/auth/group/autocomplete/	django.contrib.admin.options.autocomplete_view	admin:auth_group_autocomplete
/admin/authtoken/token/	django.contrib.admin.options.changelist_view	admin:authtoken_token_changelist
/admin/authtoken/token/<path:object_id>/	django.views.generic.base.RedirectView
/admin/authtoken/token/<path:object_id>/change/	django.contrib.admin.options.change_view	admin:authtoken_token_change
/admin/authtoken/token/<path:object_id>/delete/	django.contrib.admin.options.delete_view	admin:authtoken_token_delete
/admin/authtoken/token/<path:object_id>/history/	django.contrib.admin.options.history_view	admin:authtoken_token_history
/admin/authtoken/token/add/	django.contrib.admin.options.add_view	admin:authtoken_token_add
/admin/authtoken/token/autocomplete/	django.contrib.admin.options.autocomplete_view	admin:authtoken_token_autocomplete
/admin/design_rules/designruleresult/	django.contrib.admin.options.changelist_view	admin:design_rules_designruleresult_changelist
/admin/design_rules/designruleresult/<path:object_id>/	django.views.generic.base.RedirectView
/admin/design_rules/designruleresult/<path:object_id>/change/	django.contrib.admin.options.change_view	admin:design_rules_designruleresult_change
/admin/design_rules/designruleresult/<path:object_id>/delete/	django.contrib.admin.options.delete_view	admin:design_rules_designruleresult_delete
/admin/design_rules/designruleresult/<path:object_id>/history/	django.contrib.admin.options.history_view	admin:design_rules_designruleresult_history
/admin/design_rules/designruleresult/add/	django.contrib.admin.options.add_view	admin:design_rules_designruleresult_add
/admin/design_rules/designruleresult/autocomplete/	django.contrib.admin.options.autocomplete_view	admin:design_rules_designruleresult_autocomplete
/admin/design_rules/designrulesession/	django.contrib.admin.options.changelist_view	admin:design_rules_designrulesession_changelist
/admin/design_rules/designrulesession/<path:object_id>/	django.views.generic.base.RedirectView
/admin/design_rules/designrulesession/<path:object_id>/change/	django.contrib.admin.options.change_view	admin:design_rules_designrulesession_change
/admin/design_rules/designrulesession/<path:object_id>/delete/	django.contrib.admin.options.delete_view	admin:design_rules_designrulesession_delete
/admin/design_rules/designrulesession/<path:object_id>/history/	django.contrib.admin.options.history_view	admin:design_rules_designrulesession_history
/admin/design_rules/designrulesession/add/	django.contrib.admin.options.add_view	admin:design_rules_designrulesession_add
/admin/design_rules/designrulesession/autocomplete/	django.contrib.admin.options.autocomplete_view	admin:design_rules_designrulesession_autocomplete
/admin/design_rules/designruletestoption/	django.contrib.admin.options.changelist_view	admin:design_rules_designruletestoption_changelist
/admin/design_rules/designruletestoption/<path:object_id>/	django.views.generic.base.RedirectView
/admin/design_rules/designruletestoption/<path:object_id>/change/	django.contrib.admin.options.change_view	admin:design_rules_designruletestoption_change
/admin/design_rules/designruletestoption/<path:object_id>/delete/	django.contrib.admin.options.delete_view	admin:design_rules_designruletestoption_delete
/admin/design_rules/designruletestoption/<path:object_id>/history/	django.contrib.admin.options.history_view	admin:design_rules_designruletestoption_history
/admin/design_rules/designruletestoption/add/	django.contrib.admin.options.add_view	admin:design_rules_designruletestoption_add
/admin/design_rules/designruletestoption/autocomplete/	django.contrib.admin.options.autocomplete_view	admin:design_rules_designruletestoption_autocomplete
/admin/design_rules/designruletestsuite/	django.contrib.admin.options.changelist_view	admin:design_rules_designruletestsuite_changelist
/admin/design_rules/designruletestsuite/<path:object_id>/	django.views.generic.base.RedirectView
/admin/design_rules/designruletestsuite/<path:object_id>/change/	django.contrib.admin.options.change_view	admin:design_rules_designruletestsuite_change
/admin/design_rules/designruletestsuite/<path:object_id>/delete/	django.contrib.admin.options.delete_view	admin:design_rules_designruletestsuite_delete
/admin/design_rules/designruletestsuite/<path:object_id>/history/	django.contrib.admin.options.history_view	admin:design_rules_designruletestsuite_history
/admin/design_rules/designruletestsuite/add/	django.contrib.admin.options.add_view	admin:design_rules_designruletestsuite_add
/admin/design_rules/designruletestsuite/autocomplete/	django.contrib.admin.options.autocomplete_view	admin:design_rules_designruletestsuite_autocomplete
/admin/design_rules/designruletestversion/	django.contrib.admin.options.changelist_view	admin:design_rules_designruletestversion_changelist
/admin/design_rules/designruletestversion/<path:admin_id>/designruletestoption/<path:object_id>/move-<direction>/	ordered_model.admin.move_view	admin:design_rules_designruletestoption_change_order_inline
/admin/design_rules/designruletestversion/<path:object_id>/	django.views.generic.base.RedirectView
/admin/design_rules/designruletestversion/<path:object_id>/change/	django.contrib.admin.options.change_view	admin:design_rules_designruletestversion_change
/admin/design_rules/designruletestversion/<path:object_id>/delete/	django.contrib.admin.options.delete_view	admin:design_rules_designruletestversion_delete
/admin/design_rules/designruletestversion/<path:object_id>/history/	django.contrib.admin.options.history_view	admin:design_rules_designruletestversion_history
/admin/design_rules/designruletestversion/add/	django.contrib.admin.options.add_view	admin:design_rules_designruletestversion_add
/admin/design_rules/designruletestversion/autocomplete/	django.contrib.admin.options.autocomplete_view	admin:design_rules_designruletestversion_autocomplete
/admin/filer/clipboard/	django.contrib.admin.options.changelist_view	admin:filer_clipboard_changelist
/admin/filer/clipboard/<path:object_id>/	django.views.generic.base.RedirectView
/admin/filer/clipboard/<path:object_id>/change/	django.contrib.admin.options.change_view	admin:filer_clipboard_change
/admin/filer/clipboard/<path:object_id>/delete/	django.contrib.admin.options.delete_view	admin:filer_clipboard_delete
/admin/filer/clipboard/<path:object_id>/history/	django.contrib.admin.options.history_view	admin:filer_clipboard_history
/admin/filer/clipboard/add/	django.contrib.admin.options.add_view	admin:filer_clipboard_add
/admin/filer/clipboard/autocomplete/	django.contrib.admin.options.autocomplete_view	admin:filer_clipboard_autocomplete
/admin/filer/clipboard/operations/delete_clipboard/	filer.admin.views.delete_clipboard	admin:filer-delete_clipboard
/admin/filer/clipboard/operations/discard_clipboard/	filer.admin.views.discard_clipboard	admin:filer-discard_clipboard
/admin/filer/clipboard/operations/paste_clipboard_to_folder/	filer.admin.views.paste_clipboard_to_folder	admin:filer-paste_clipboard_to_folder
/admin/filer/clipboard/operations/upload/<folder_id>/	filer.admin.clipboardadmin.ajax_upload	admin:filer-ajax_upload
/admin/filer/clipboard/operations/upload/no_folder/	filer.admin.clipboardadmin.ajax_upload	admin:filer-ajax_upload
/admin/filer/file/	django.contrib.admin.options.changelist_view	admin:filer_file_changelist
/admin/filer/file/<path:object_id>/	django.views.generic.base.RedirectView
/admin/filer/file/<path:object_id>/change/	django.contrib.admin.options.change_view	admin:filer_file_change
/admin/filer/file/<path:object_id>/delete/	filer.admin.fileadmin.delete_view	admin:filer_file_delete
/admin/filer/file/<path:object_id>/history/	django.contrib.admin.options.history_view	admin:filer_file_history
/admin/filer/file/add/	django.contrib.admin.options.add_view	admin:filer_file_add
/admin/filer/file/autocomplete/	django.contrib.admin.options.autocomplete_view	admin:filer_file_autocomplete
/admin/filer/folder/	django.contrib.admin.options.changelist_view	admin:filer_folder_changelist
/admin/filer/folder/	filer.admin.folderadmin.directory_listing	admin:filer-directory_listing-root
/admin/filer/folder/<folder_id>/list/	filer.admin.folderadmin.directory_listing	admin:filer-directory_listing
/admin/filer/folder/<folder_id>/make_folder/	filer.admin.views.make_folder	admin:filer-directory_listing-make_folder
/admin/filer/folder/<path:object_id>/	django.views.generic.base.RedirectView
/admin/filer/folder/<path:object_id>/change/	django.contrib.admin.options.change_view	admin:filer_folder_change
/admin/filer/folder/<path:object_id>/delete/	filer.admin.folderadmin.delete_view	admin:filer_folder_delete
/admin/filer/folder/<path:object_id>/history/	django.contrib.admin.options.history_view	admin:filer_folder_history
/admin/filer/folder/add/	django.contrib.admin.options.add_view	admin:filer_folder_add
/admin/filer/folder/autocomplete/	django.contrib.admin.options.autocomplete_view	admin:filer_folder_autocomplete
/admin/filer/folder/images_with_missing_data/	filer.admin.folderadmin.directory_listing	admin:filer-directory_listing-images_with_missing_data
/admin/filer/folder/last/	filer.admin.folderadmin.directory_listing	admin:filer-directory_listing-last
/admin/filer/folder/make_folder/	filer.admin.views.make_folder	admin:filer-directory_listing-make_root_folder
/admin/filer/folder/unfiled_images/	filer.admin.folderadmin.directory_listing	admin:filer-directory_listing-unfiled_images
/admin/filer/folderpermission/	django.contrib.admin.options.changelist_view	admin:filer_folderpermission_changelist
/admin/filer/folderpermission/<path:object_id>/	django.views.generic.base.RedirectView
/admin/filer/folderpermission/<path:object_id>/change/	django.contrib.admin.options.change_view	admin:filer_folderpermission_change
/admin/filer/folderpermission/<path:object_id>/delete/	django.contrib.admin.options.delete_view	admin:filer_folderpermission_delete
/admin/filer/folderpermission/<path:object_id>/history/	django.contrib.admin.options.history_view	admin:filer_folderpermission_history
/admin/filer/folderpermission/add/	django.contrib.admin.options.add_view	admin:filer_folderpermission_add
/admin/filer/folderpermission/autocomplete/	django.contrib.admin.options.autocomplete_view	admin:filer_folderpermission_autocomplete
/admin/filer/image/	django.contrib.admin.options.changelist_view	admin:filer_image_changelist
/admin/filer/image/<path:object_id>/	django.views.generic.base.RedirectView
/admin/filer/image/<path:object_id>/change/	django.contrib.admin.options.change_view	admin:filer_image_change
/admin/filer/image/<path:object_id>/delete/	filer.admin.fileadmin.delete_view	admin:filer_image_delete
/admin/filer/image/<path:object_id>/history/	django.contrib.admin.options.history_view	admin:filer_image_history
/admin/filer/image/add/	django.contrib.admin.options.add_view	admin:filer_image_add
/admin/filer/image/autocomplete/	django.contrib.admin.options.autocomplete_view	admin:filer_image_autocomplete
/admin/filer/thumbnailoption/	django.contrib.admin.options.changelist_view	admin:filer_thumbnailoption_changelist
/admin/filer/thumbnailoption/<path:object_id>/	django.views.generic.base.RedirectView
/admin/filer/thumbnailoption/<path:object_id>/change/	django.contrib.admin.options.change_view	admin:filer_thumbnailoption_change
/admin/filer/thumbnailoption/<path:object_id>/delete/	django.contrib.admin.options.delete_view	admin:filer_thumbnailoption_delete
/admin/filer/thumbnailoption/<path:object_id>/history/	django.contrib.admin.options.history_view	admin:filer_thumbnailoption_history
/admin/filer/thumbnailoption/add/	django.contrib.admin.options.add_view	admin:filer_thumbnailoption_add
/admin/filer/thumbnailoption/autocomplete/	django.contrib.admin.options.autocomplete_view	admin:filer_thumbnailoption_autocomplete
/admin/flatpages/flatpage/	django.contrib.admin.options.changelist_view	admin:flatpages_flatpage_changelist
/admin/flatpages/flatpage/<path:object_id>/	django.views.generic.base.RedirectView
/admin/flatpages/flatpage/<path:object_id>/change/	django.contrib.admin.options.change_view	admin:flatpages_flatpage_change
/admin/flatpages/flatpage/<path:object_id>/delete/	django.contrib.admin.options.delete_view	admin:flatpages_flatpage_delete
/admin/flatpages/flatpage/<path:object_id>/history/	django.contrib.admin.options.history_view	admin:flatpages_flatpage_history
/admin/flatpages/flatpage/add/	django.contrib.admin.options.add_view	admin:flatpages_flatpage_add
/admin/flatpages/flatpage/autocomplete/	django.contrib.admin.options.autocomplete_view	admin:flatpages_flatpage_autocomplete
/admin/hijack/<user_id>/	hijack.views.login_with_id	hijack:login_with_id
/admin/hijack/disable-hijack-warning/	hijack.views.disable_hijack_warning	hijack:disable_hijack_warning
/admin/hijack/email/<email>/	hijack.views.login_with_email	hijack:login_with_email
/admin/hijack/release-hijack/	hijack.views.release_hijack	hijack:release_hijack
/admin/hijack/username/<username>/	hijack.views.login_with_username	hijack:login_with_username
/admin/jsi18n/	django.contrib.admin.sites.i18n_javascript	admin:jsi18n
/admin/login/	django.contrib.admin.sites.login	admin:login
/admin/logout/	django.contrib.admin.sites.logout	admin:logout
/admin/mobetta	mobetta.views.LanguageListView	mobetta:language_list
/admin/mobetta/translationfile/	django.contrib.admin.options.changelist_view	admin:mobetta_translationfile_changelist
/admin/mobetta/translationfile/<path:object_id>/	django.views.generic.base.RedirectView
/admin/mobetta/translationfile/<path:object_id>/change/	django.contrib.admin.options.change_view	admin:mobetta_translationfile_change
/admin/mobetta/translationfile/<path:object_id>/delete/	django.contrib.admin.options.delete_view	admin:mobetta_translationfile_delete
/admin/mobetta/translationfile/<path:object_id>/history/	django.contrib.admin.options.history_view	admin:mobetta_translationfile_history
/admin/mobetta/translationfile/add/	django.contrib.admin.options.add_view	admin:mobetta_translationfile_add
/admin/mobetta/translationfile/autocomplete/	django.contrib.admin.options.autocomplete_view	admin:mobetta_translationfile_autocomplete
/admin/mobettaadd_translator/	mobetta.views.AddTranslatorView	mobetta:add_translator
/admin/mobettaapi/	rest_framework.routers.APIRootView	mobetta:api:api-root
/admin/mobettaapi/\.<format>/	rest_framework.routers.APIRootView	mobetta:api:api-root
/admin/mobettaapi/auth/login/	django.contrib.auth.views.LoginView	mobetta:api:rest_framework:login
/admin/mobettaapi/auth/logout/	django.contrib.auth.views.LogoutView	mobetta:api:rest_framework:logout
/admin/mobettaapi/comments/	mobetta.api.views.MessageCommentViewSet	mobetta:api:messagecomment-list
/admin/mobettaapi/comments/<pk>/	mobetta.api.views.MessageCommentViewSet	mobetta:api:messagecomment-detail
/admin/mobettaapi/comments/<pk>\.<format>/	mobetta.api.views.MessageCommentViewSet	mobetta:api:messagecomment-detail
/admin/mobettaapi/comments\.<format>/	mobetta.api.views.MessageCommentViewSet	mobetta:api:messagecomment-list
/admin/mobettaapi/files/	mobetta.api.views.TranslationFileViewSet	mobetta:api:translationfile-list
/admin/mobettaapi/files/<pk>/	mobetta.api.views.TranslationFileViewSet	mobetta:api:translationfile-detail
/admin/mobettaapi/files/<pk>\.<format>/	mobetta.api.views.TranslationFileViewSet	mobetta:api:translationfile-detail
/admin/mobettaapi/files\.<format>/	mobetta.api.views.TranslationFileViewSet	mobetta:api:translationfile-list
/admin/mobettaapi/suggestion/	mobetta.api.views.TranslationSuggestionsView	mobetta:api:translation_suggestion
/admin/mobettacompile/	mobetta.views.CompilePoFilesView	mobetta:compile_po_files
/admin/mobettadownload/<pk>/	mobetta.views.FileDownloadView	mobetta:download
/admin/mobettaedit_log/<pk>/	mobetta.views.EditHistoryView	mobetta:edit_history
/admin/mobettafile/<pk>/	mobetta.views.FileDetailView	mobetta:file_detail
/admin/mobettafind/	mobetta.views.FindPoFilesView	mobetta:find_po_files
/admin/mobettalanguage/<lang_code>/	mobetta.views.FileListView	mobetta:file_list
/admin/password_change/	django.contrib.admin.sites.password_change	admin:password_change
/admin/password_change/done/	django.contrib.admin.sites.password_change_done	admin:password_change_done
/admin/password_reset/	django.contrib.auth.views.PasswordResetView	admin_password_reset
/admin/password_reset/done/	django.contrib.auth.views.PasswordResetDoneView	password_reset_done
/admin/r/<int:content_type_id>/<path:object_id>/	django.contrib.contenttypes.views.shortcut	admin:view_on_site
/admin/registration/registrationprofile/	django.contrib.admin.options.changelist_view	admin:registration_registrationprofile_changelist
/admin/registration/registrationprofile/<path:object_id>/	django.views.generic.base.RedirectView
/admin/registration/registrationprofile/<path:object_id>/change/	django.contrib.admin.options.change_view	admin:registration_registrationprofile_change
/admin/registration/registrationprofile/<path:object_id>/delete/	django.contrib.admin.options.delete_view	admin:registration_registrationprofile_delete
/admin/registration/registrationprofile/<path:object_id>/history/	django.contrib.admin.options.history_view	admin:registration_registrationprofile_history
/admin/registration/registrationprofile/add/	django.contrib.admin.options.add_view	admin:registration_registrationprofile_add
/admin/registration/registrationprofile/autocomplete/	django.contrib.admin.options.autocomplete_view	admin:registration_registrationprofile_autocomplete
/admin/servervalidation/api/	django.contrib.admin.options.changelist_view	admin:servervalidation_api_changelist
/admin/servervalidation/api/<object_pk>/permissions/	guardian.admin.obj_perms_manage_view	admin:servervalidation_api_permissions
/admin/servervalidation/api/<object_pk>/permissions/group-manage/<group_id>/	guardian.admin.obj_perms_manage_group_view	admin:servervalidation_api_permissions_manage_group
/admin/servervalidation/api/<object_pk>/permissions/user-manage/<user_id>/	guardian.admin.obj_perms_manage_user_view	admin:servervalidation_api_permissions_manage_user
/admin/servervalidation/api/<path:object_id>/	django.views.generic.base.RedirectView
/admin/servervalidation/api/<path:object_id>/change/	django.contrib.admin.options.change_view	admin:servervalidation_api_change
/admin/servervalidation/api/<path:object_id>/delete/	django.contrib.admin.options.delete_view	admin:servervalidation_api_delete
/admin/servervalidation/api/<path:object_id>/history/	django.contrib.admin.options.history_view	admin:servervalidation_api_history
/admin/servervalidation/api/add/	django.contrib.admin.options.add_view	admin:servervalidation_api_add
/admin/servervalidation/api/autocomplete/	django.contrib.admin.options.autocomplete_view	admin:servervalidation_api_autocomplete
/admin/servervalidation/endpoint/	django.contrib.admin.options.changelist_view	admin:servervalidation_endpoint_changelist
/admin/servervalidation/endpoint/<path:object_id>/	django.views.generic.base.RedirectView
/admin/servervalidation/endpoint/<path:object_id>/change/	django.contrib.admin.options.change_view	admin:servervalidation_endpoint_change
/admin/servervalidation/endpoint/<path:object_id>/delete/	django.contrib.admin.options.delete_view	admin:servervalidation_endpoint_delete
/admin/servervalidation/endpoint/<path:object_id>/history/	django.contrib.admin.options.history_view	admin:servervalidation_endpoint_history
/admin/servervalidation/endpoint/add/	django.contrib.admin.options.add_view	admin:servervalidation_endpoint_add
/admin/servervalidation/endpoint/autocomplete/	django.contrib.admin.options.autocomplete_view	admin:servervalidation_endpoint_autocomplete
/admin/servervalidation/environment/	django.contrib.admin.options.changelist_view	admin:servervalidation_environment_changelist
/admin/servervalidation/environment/<path:object_id>/	django.views.generic.base.RedirectView
/admin/servervalidation/environment/<path:object_id>/change/	django.contrib.admin.options.change_view	admin:servervalidation_environment_change
/admin/servervalidation/environment/<path:object_id>/delete/	django.contrib.admin.options.delete_view	admin:servervalidation_environment_delete
/admin/servervalidation/environment/<path:object_id>/history/	django.contrib.admin.options.history_view	admin:servervalidation_environment_history
/admin/servervalidation/environment/add/	django.contrib.admin.options.add_view	admin:servervalidation_environment_add
/admin/servervalidation/environment/autocomplete/	django.contrib.admin.options.autocomplete_view	admin:servervalidation_environment_autocomplete
/admin/servervalidation/postmantest/	ordered_model.admin.changelist_view	admin:servervalidation_postmantest_changelist
/admin/servervalidation/postmantest/<path:object_id>/	django.views.generic.base.RedirectView
/admin/servervalidation/postmantest/<path:object_id>/change/	django.contrib.admin.options.change_view	admin:servervalidation_postmantest_change
/admin/servervalidation/postmantest/<path:object_id>/delete/	django.contrib.admin.options.delete_view	admin:servervalidation_postmantest_delete
/admin/servervalidation/postmantest/<path:object_id>/history/	django.contrib.admin.options.history_view	admin:servervalidation_postmantest_history
/admin/servervalidation/postmantest/<path:object_id>/move-<direction>/	ordered_model.admin.move_view	admin:servervalidation_postmantest_change_order
/admin/servervalidation/postmantest/add/	django.contrib.admin.options.add_view	admin:servervalidation_postmantest_add
/admin/servervalidation/postmantest/autocomplete/	django.contrib.admin.options.autocomplete_view	admin:servervalidation_postmantest_autocomplete
/admin/servervalidation/postmantestresult/	django.contrib.admin.options.changelist_view	admin:servervalidation_postmantestresult_changelist
/admin/servervalidation/postmantestresult/<path:object_id>/	django.views.generic.base.RedirectView
/admin/servervalidation/postmantestresult/<path:object_id>/change/	django.contrib.admin.options.change_view	admin:servervalidation_postmantestresult_change
/admin/servervalidation/postmantestresult/<path:object_id>/delete/	django.contrib.admin.options.delete_view	admin:servervalidation_postmantestresult_delete
/admin/servervalidation/postmantestresult/<path:object_id>/history/	django.contrib.admin.options.history_view	admin:servervalidation_postmantestresult_history
/admin/servervalidation/postmantestresult/add/	django.contrib.admin.options.add_view	admin:servervalidation_postmantestresult_add
/admin/servervalidation/postmantestresult/autocomplete/	django.contrib.admin.options.autocomplete_view	admin:servervalidation_postmantestresult_autocomplete
/admin/servervalidation/scheduledtestscenario/	django.contrib.admin.options.changelist_view	admin:servervalidation_scheduledtestscenario_changelist
/admin/servervalidation/scheduledtestscenario/<path:object_id>/	django.views.generic.base.RedirectView
/admin/servervalidation/scheduledtestscenario/<path:object_id>/change/	django.contrib.admin.options.change_view	admin:servervalidation_scheduledtestscenario_change
/admin/servervalidation/scheduledtestscenario/<path:object_id>/delete/	django.contrib.admin.options.delete_view	admin:servervalidation_scheduledtestscenario_delete
/admin/servervalidation/scheduledtestscenario/<path:object_id>/history/	django.contrib.admin.options.history_view	admin:servervalidation_scheduledtestscenario_history
/admin/servervalidation/scheduledtestscenario/add/	django.contrib.admin.options.add_view	admin:servervalidation_scheduledtestscenario_add
/admin/servervalidation/scheduledtestscenario/autocomplete/	django.contrib.admin.options.autocomplete_view	admin:servervalidation_scheduledtestscenario_autocomplete
/admin/servervalidation/serverrun/	django.contrib.admin.options.changelist_view	admin:servervalidation_serverrun_changelist
/admin/servervalidation/serverrun/<path:object_id>/	django.views.generic.base.RedirectView
/admin/servervalidation/serverrun/<path:object_id>/change/	django.contrib.admin.options.change_view	admin:servervalidation_serverrun_change
/admin/servervalidation/serverrun/<path:object_id>/delete/	django.contrib.admin.options.delete_view	admin:servervalidation_serverrun_delete
/admin/servervalidation/serverrun/<path:object_id>/history/	django.contrib.admin.options.history_view	admin:servervalidation_serverrun_history
/admin/servervalidation/serverrun/add/	django.contrib.admin.options.add_view	admin:servervalidation_serverrun_add
/admin/servervalidation/serverrun/autocomplete/	django.contrib.admin.options.autocomplete_view	admin:servervalidation_serverrun_autocomplete
/admin/servervalidation/testscenario/	django.contrib.admin.options.changelist_view	admin:servervalidation_testscenario_changelist
/admin/servervalidation/testscenario/<path:object_id>/	django.views.generic.base.RedirectView
/admin/servervalidation/testscenario/<path:object_id>/change/	django.contrib.admin.options.change_view	admin:servervalidation_testscenario_change
/admin/servervalidation/testscenario/<path:object_id>/delete/	django.contrib.admin.options.delete_view	admin:servervalidation_testscenario_delete
/admin/servervalidation/testscenario/<path:object_id>/history/	django.contrib.admin.options.history_view	admin:servervalidation_testscenario_history
/admin/servervalidation/testscenario/add/	django.contrib.admin.options.add_view	admin:servervalidation_testscenario_add
/admin/servervalidation/testscenario/autocomplete/	django.contrib.admin.options.autocomplete_view	admin:servervalidation_testscenario_autocomplete
/admin/servervalidation/testscenariourl/	django.contrib.admin.options.changelist_view	admin:servervalidation_testscenariourl_changelist
/admin/servervalidation/testscenariourl/<path:object_id>/	django.views.generic.base.RedirectView
/admin/servervalidation/testscenariourl/<path:object_id>/change/	django.contrib.admin.options.change_view	admin:servervalidation_testscenariourl_change
/admin/servervalidation/testscenariourl/<path:object_id>/delete/	django.contrib.admin.options.delete_view	admin:servervalidation_testscenariourl_delete
/admin/servervalidation/testscenariourl/<path:object_id>/history/	django.contrib.admin.options.history_view	admin:servervalidation_testscenariourl_history
/admin/servervalidation/testscenariourl/add/	django.contrib.admin.options.add_view	admin:servervalidation_testscenariourl_add
/admin/servervalidation/testscenariourl/autocomplete/	django.contrib.admin.options.autocomplete_view	admin:servervalidation_testscenariourl_autocomplete
/admin/sites/site/	django.contrib.admin.options.changelist_view	admin:sites_site_changelist
/admin/sites/site/<path:object_id>/	django.views.generic.base.RedirectView
/admin/sites/site/<path:object_id>/change/	django.contrib.admin.options.change_view	admin:sites_site_change
/admin/sites/site/<path:object_id>/delete/	django.contrib.admin.options.delete_view	admin:sites_site_delete
/admin/sites/site/<path:object_id>/history/	django.contrib.admin.options.history_view	admin:sites_site_history
/admin/sites/site/add/	django.contrib.admin.options.add_view	admin:sites_site_add
/admin/sites/site/autocomplete/	django.contrib.admin.options.autocomplete_view	admin:sites_site_autocomplete
/admin/testsession/environmentalvariables/	django.contrib.admin.options.changelist_view	admin:testsession_environmentalvariables_changelist
/admin/testsession/environmentalvariables/<path:object_id>/	django.views.generic.base.RedirectView
/admin/testsession/environmentalvariables/<path:object_id>/change/	django.contrib.admin.options.change_view	admin:testsession_environmentalvariables_change
/admin/testsession/environmentalvariables/<path:object_id>/delete/	django.contrib.admin.options.delete_view	admin:testsession_environmentalvariables_delete
/admin/testsession/environmentalvariables/<path:object_id>/history/	django.contrib.admin.options.history_view	admin:testsession_environmentalvariables_history
/admin/testsession/environmentalvariables/add/	django.contrib.admin.options.add_view	admin:testsession_environmentalvariables_add
/admin/testsession/environmentalvariables/autocomplete/	django.contrib.admin.options.autocomplete_view	admin:testsession_environmentalvariables_autocomplete
/admin/testsession/exposedurl/	django.contrib.admin.options.changelist_view	admin:testsession_exposedurl_changelist
/admin/testsession/exposedurl/<path:object_id>/	django.views.generic.base.RedirectView
/admin/testsession/exposedurl/<path:object_id>/change/	django.contrib.admin.options.change_view	admin:testsession_exposedurl_change
/admin/testsession/exposedurl/<path:object_id>/delete/	django.contrib.admin.options.delete_view	admin:testsession_exposedurl_delete
/admin/testsession/exposedurl/<path:object_id>/history/	django.contrib.admin.options.history_view	admin:testsession_exposedurl_history
/admin/testsession/exposedurl/add/	django.contrib.admin.options.add_view	admin:testsession_exposedurl_add
/admin/testsession/exposedurl/autocomplete/	django.contrib.admin.options.autocomplete_view	admin:testsession_exposedurl_autocomplete
/admin/testsession/injectheader/	django.contrib.admin.options.changelist_view	admin:testsession_injectheader_changelist
/admin/testsession/injectheader/<path:object_id>/	django.views.generic.base.RedirectView
/admin/testsession/injectheader/<path:object_id>/change/	django.contrib.admin.options.change_view	admin:testsession_injectheader_change
/admin/testsession/injectheader/<path:object_id>/delete/	django.contrib.admin.options.delete_view	admin:testsession_injectheader_delete
/admin/testsession/injectheader/<path:object_id>/history/	django.contrib.admin.options.history_view	admin:testsession_injectheader_history
/admin/testsession/injectheader/add/	django.contrib.admin.options.add_view	admin:testsession_injectheader_add
/admin/testsession/injectheader/autocomplete/	django.contrib.admin.options.autocomplete_view	admin:testsession_injectheader_autocomplete
/admin/testsession/queryparamsscenario/	django.contrib.admin.options.changelist_view	admin:testsession_queryparamsscenario_changelist
/admin/testsession/queryparamsscenario/<path:object_id>/	django.views.generic.base.RedirectView
/admin/testsession/queryparamsscenario/<path:object_id>/change/	django.contrib.admin.options.change_view	admin:testsession_queryparamsscenario_change
/admin/testsession/queryparamsscenario/<path:object_id>/delete/	django.contrib.admin.options.delete_view	admin:testsession_queryparamsscenario_delete
/admin/testsession/queryparamsscenario/<path:object_id>/history/	django.contrib.admin.options.history_view	admin:testsession_queryparamsscenario_history
/admin/testsession/queryparamsscenario/add/	django.contrib.admin.options.add_view	admin:testsession_queryparamsscenario_add
/admin/testsession/queryparamsscenario/autocomplete/	django.contrib.admin.options.autocomplete_view	admin:testsession_queryparamsscenario_autocomplete
/admin/testsession/report/	django.contrib.admin.options.changelist_view	admin:testsession_report_changelist
/admin/testsession/report/<path:object_id>/	django.views.generic.base.RedirectView
/admin/testsession/report/<path:object_id>/change/	django.contrib.admin.options.change_view	admin:testsession_report_change
/admin/testsession/report/<path:object_id>/delete/	django.contrib.admin.options.delete_view	admin:testsession_report_delete
/admin/testsession/report/<path:object_id>/history/	django.contrib.admin.options.history_view	admin:testsession_report_history
/admin/testsession/report/add/	django.contrib.admin.options.add_view	admin:testsession_report_add
/admin/testsession/report/autocomplete/	django.contrib.admin.options.autocomplete_view	admin:testsession_report_autocomplete
/admin/testsession/scenariocase/	ordered_model.admin.changelist_view	admin:testsession_scenariocase_changelist
/admin/testsession/scenariocase/<path:object_id>/	django.views.generic.base.RedirectView
/admin/testsession/scenariocase/<path:object_id>/change/	django.contrib.admin.options.change_view	admin:testsession_scenariocase_change
/admin/testsession/scenariocase/<path:object_id>/delete/	django.contrib.admin.options.delete_view	admin:testsession_scenariocase_delete
/admin/testsession/scenariocase/<path:object_id>/history/	django.contrib.admin.options.history_view	admin:testsession_scenariocase_history
/admin/testsession/scenariocase/<path:object_id>/move-<direction>/	ordered_model.admin.move_view	admin:testsession_scenariocase_change_order
/admin/testsession/scenariocase/add/	django.contrib.admin.options.add_view	admin:testsession_scenariocase_add
/admin/testsession/scenariocase/autocomplete/	django.contrib.admin.options.autocomplete_view	admin:testsession_scenariocase_autocomplete
/admin/testsession/scenariocasecollection/	django.contrib.admin.options.changelist_view	admin:testsession_scenariocasecollection_changelist
/admin/testsession/scenariocasecollection/<path:admin_id>/scenariocase/<path:object_id>/move-<direction>/	ordered_model.admin.move_view	admin:testsession_scenariocase_change_order_inline
/admin/testsession/scenariocasecollection/<path:object_id>/	django.views.generic.base.RedirectView
/admin/testsession/scenariocasecollection/<path:object_id>/change/	django.contrib.admin.options.change_view	admin:testsession_scenariocasecollection_change
/admin/testsession/scenariocasecollection/<path:object_id>/delete/	django.contrib.admin.options.delete_view	admin:testsession_scenariocasecollection_delete
/admin/testsession/scenariocasecollection/<path:object_id>/history/	django.contrib.admin.options.history_view	admin:testsession_scenariocasecollection_history
/admin/testsession/scenariocasecollection/add/	django.contrib.admin.options.add_view	admin:testsession_scenariocasecollection_add
/admin/testsession/scenariocasecollection/autocomplete/	django.contrib.admin.options.autocomplete_view	admin:testsession_scenariocasecollection_autocomplete
/admin/testsession/session/	django.contrib.admin.options.changelist_view	admin:testsession_session_changelist
/admin/testsession/session/<path:object_id>/	django.views.generic.base.RedirectView
/admin/testsession/session/<path:object_id>/change/	django.contrib.admin.options.change_view	admin:testsession_session_change
/admin/testsession/session/<path:object_id>/delete/	django.contrib.admin.options.delete_view	admin:testsession_session_delete
/admin/testsession/session/<path:object_id>/history/	django.contrib.admin.options.history_view	admin:testsession_session_history
/admin/testsession/session/add/	django.contrib.admin.options.add_view	admin:testsession_session_add
/admin/testsession/session/autocomplete/	django.contrib.admin.options.autocomplete_view	admin:testsession_session_autocomplete
/admin/testsession/sessionlog/	django.contrib.admin.options.changelist_view	admin:testsession_sessionlog_changelist
/admin/testsession/sessionlog/<path:object_id>/	django.views.generic.base.RedirectView
/admin/testsession/sessionlog/<path:object_id>/change/	django.contrib.admin.options.change_view	admin:testsession_sessionlog_change
/admin/testsession/sessionlog/<path:object_id>/delete/	django.contrib.admin.options.delete_view	admin:testsession_sessionlog_delete
/admin/testsession/sessionlog/<path:object_id>/history/	django.contrib.admin.options.history_view	admin:testsession_sessionlog_history
/admin/testsession/sessionlog/add/	django.contrib.admin.options.add_view	admin:testsession_sessionlog_add
/admin/testsession/sessionlog/autocomplete/	django.contrib.admin.options.autocomplete_view	admin:testsession_sessionlog_autocomplete
/admin/testsession/sessiontype/	django.contrib.admin.options.changelist_view	admin:testsession_sessiontype_changelist
/admin/testsession/sessiontype/<path:admin_id>/vngendpoint/<path:object_id>/move-<direction>/	ordered_model.admin.move_view	admin:testsession_vngendpoint_change_order_inline
/admin/testsession/sessiontype/<path:object_id>/	django.views.generic.base.RedirectView
/admin/testsession/sessiontype/<path:object_id>/change/	django.contrib.admin.options.change_view	admin:testsession_sessiontype_change
/admin/testsession/sessiontype/<path:object_id>/delete/	django.contrib.admin.options.delete_view	admin:testsession_sessiontype_delete
/admin/testsession/sessiontype/<path:object_id>/history/	django.contrib.admin.options.history_view	admin:testsession_sessiontype_history
/admin/testsession/sessiontype/add/	django.contrib.admin.options.add_view	admin:testsession_sessiontype_add
/admin/testsession/sessiontype/autocomplete/	django.contrib.admin.options.autocomplete_view	admin:testsession_sessiontype_autocomplete
/admin/testsession/testsession/	django.contrib.admin.options.changelist_view	admin:testsession_testsession_changelist
/admin/testsession/testsession/<path:object_id>/	django.views.generic.base.RedirectView
/admin/testsession/testsession/<path:object_id>/change/	django.contrib.admin.options.change_view	admin:testsession_testsession_change
/admin/testsession/testsession/<path:object_id>/delete/	django.contrib.admin.options.delete_view	admin:testsession_testsession_delete
/admin/testsession/testsession/<path:object_id>/history/	django.contrib.admin.options.history_view	admin:testsession_testsession_history
/admin/testsession/testsession/add/	django.contrib.admin.options.add_view	admin:testsession_testsession_add
/admin/testsession/testsession/autocomplete/	django.contrib.admin.options.autocomplete_view	admin:testsession_testsession_autocomplete
/admin/testsession/vngendpoint/	ordered_model.admin.changelist_view	admin:testsession_vngendpoint_changelist
/admin/testsession/vngendpoint/<path:object_id>/	django.views.generic.base.RedirectView
/admin/testsession/vngendpoint/<path:object_id>/change/	django.contrib.admin.options.change_view	admin:testsession_vngendpoint_change
/admin/testsession/vngendpoint/<path:object_id>/delete/	django.contrib.admin.options.delete_view	admin:testsession_vngendpoint_delete
/admin/testsession/vngendpoint/<path:object_id>/history/	django.contrib.admin.options.history_view	admin:testsession_vngendpoint_history
/admin/testsession/vngendpoint/<path:object_id>/move-<direction>/	ordered_model.admin.move_view	admin:testsession_vngendpoint_change_order
/admin/testsession/vngendpoint/add/	django.contrib.admin.options.add_view	admin:testsession_vngendpoint_add
/admin/testsession/vngendpoint/autocomplete/	django.contrib.admin.options.autocomplete_view	admin:testsession_vngendpoint_autocomplete
/api/v1/	rest_framework.routers.APIRootView	apiv1server:provider:api-root
/api/v1/\.<format>/	rest_framework.routers.APIRootView	apiv1server:provider:api-root
/api/v1/auth/login	vng.api_authentication.views.CustomLoginView	apiv1_auth:rest_login
/api/v1/auth/logout	vng.api_authentication.views.CustomLogoutView	apiv1_auth:rest_logout
/api/v1/auth/mytokens	vng.api_authentication.views.TokenManager	apiv1_auth:token-manager
/api/v1/auth/password/change	rest_auth.views.PasswordChangeView	apiv1_auth:rest_password_change
/api/v1/auth/password/reset	rest_auth.views.PasswordResetView	apiv1_auth:rest_password_reset
/api/v1/auth/password/reset/confirm	rest_auth.views.PasswordResetConfirmView	apiv1_auth:rest_password_reset_confirm
/api/v1/auth/user	rest_auth.views.UserDetailsView	apiv1_auth:rest_user_details
/api/v1/designrule-session	vng.api.v1.design_rules.viewsets.DesignRuleSessionViewSet	api_v1_design_rules:session-list
/api/v1/designrule-session/<uuid>	vng.api.v1.design_rules.viewsets.DesignRuleSessionViewSet	api_v1_design_rules:session-detail
/api/v1/designrule-session/shield/<uuid:uuid>	vng.api.v1.design_rules.viewsets.DesignRuleSessionShieldView	api_v1_design_rules:design_rule-shield
/api/v1/designrule-testsuite	vng.api.v1.design_rules.viewsets.DesignRuleTestSuiteViewSet	api_v1_design_rules:test_suite-list
/api/v1/designrule-testsuite/<uuid>	vng.api.v1.design_rules.viewsets.DesignRuleTestSuiteViewSet	api_v1_design_rules:test_suite-detail
/api/v1/designrule-testsuite/<uuid>/start_session	vng.api.v1.design_rules.viewsets.DesignRuleTestSuiteViewSet	api_v1_design_rules:test_suite-start-session
/api/v1/designrule-testversion	vng.api.v1.design_rules.viewsets.DesignRuleTestVersionViewSet	api_v1_design_rules:test_versions-list
/api/v1/exposed_url	vng.api.v1.testsession.views.ExposedUrlView	apiv1session:exposed_url-list
/api/v1/openAPIinspector	vng.openApiInspector.api_views.OpenApiInspectionAPIView	apiv1inspector:openAPIinspection
/api/v1/openapi.json	drf_spectacular.views.SpectacularJSONAPIView	api-schema
/api/v1/postman-test	vng.servervalidation.api_views.PostmanTestViewset	apiv1server:provider:api_postman-test-list
/api/v1/postman-test/<pk>	vng.servervalidation.api_views.PostmanTestViewset	apiv1server:provider:api_postman-test-detail
/api/v1/postman-test/<pk>\.<format>/	vng.servervalidation.api_views.PostmanTestViewset	apiv1server:provider:api_postman-test-detail
/api/v1/postman-test/get_version/<name>/<version>	vng.servervalidation.api_views.PostmanTestViewset	apiv1server:provider:api_postman-test-get-specific-version
/api/v1/postman-test/get_version/<name>/<version>\.<format>/	vng.servervalidation.api_views.PostmanTestViewset	apiv1server:provider:api_postman-test-get-specific-version
/api/v1/postman-test/get_versions/<name>	vng.servervalidation.api_views.PostmanTestViewset	apiv1server:provider:api_postman-test-get-all-versions
/api/v1/postman-test/get_versions/<name>\.<format>/	vng.servervalidation.api_views.PostmanTestViewset	apiv1server:provider:api_postman-test-get-all-versions
/api/v1/postman-test\.<format>/	vng.servervalidation.api_views.PostmanTestViewset	apiv1server:provider:api_postman-test-list
/api/v1/provider-latest-badge/<uuid:uuid>/	vng.servervalidation.api_views.ServerRunLatestResultView	apiv1server:latest-badge
/api/v1/provider-run	vng.servervalidation.api_views.ServerRunViewSet	apiv1server:provider:api_server-run-list
/api/v1/provider-run-shield/<uuid:uuid>/	vng.servervalidation.api_views.ResultServerViewShield	apiv1server:api_server-run-shield
/api/v1/provider-run/<uuid:uuid>/result	vng.servervalidation.api_views.ResultServerView	apiv1server:provider_result
/api/v1/provider-run/<uuid>	vng.servervalidation.api_views.ServerRunViewSet	apiv1server:provider:api_server-run-detail
/api/v1/provider-run/<uuid>\.<format>/	vng.servervalidation.api_views.ServerRunViewSet	apiv1server:provider:api_server-run-detail
/api/v1/provider-run\.<format>/	vng.servervalidation.api_views.ServerRunViewSet	apiv1server:provider:api_server-run-list
/api/v1/schema	drf_spectacular.views.SpectacularRedocView	schema-redoc
/api/v1/sessiontypes	vng.api.v1.testsession.views.SessionTypesViewSet	apiv1session:session_types-list
/api/v1/status/<uuid>	vng.api.v1.testsession.views.SessionViewStatusSet	apiv1session:test_session-status-detail
/api/v1/testsession-run-shield/<uuid:uuid>/	vng.api.v1.testsession.views.ResultTestsessionViewShield	apiv1session:testsession-shield
/api/v1/testsessions	vng.api.v1.testsession.views.SessionViewSet	apiv1session:test_session-list
/api/v1/testsessions/<uuid:uuid>/result	vng.api.v1.testsession.views.ResultSessionView	apiv1session:result_session
/api/v1/testsessions/<uuid:uuid>/stop	vng.api.v1.testsession.views.StopSessionView	apiv1session:stop_session
/api/v1/testsessions/<uuid>	vng.api.v1.testsession.views.SessionViewSet	apiv1session:test_session-detail
/atvmedia/<path>	django.views.static.serve
/atvstatic/<path>	django.contrib.staticfiles.views.serve
/consumer/<int:api_id>/	vng.testsession.views.SessionListView	testsession:sessions
/consumer/<int:api_id>/<uuid:uuid>/	vng.testsession.views.SessionLogView	testsession:session_log
/consumer/<int:api_id>/<uuid:uuid>/log/<uuid:log_uuid>/	vng.testsession.views.SessionLogDetailView	testsession:session_log-detail
/consumer/<int:api_id>/<uuid:uuid>/report-pdf/	vng.testsession.views.SessionReportPdf	testsession:session_report-pdf
/consumer/<int:api_id>/<uuid:uuid>/report/	vng.testsession.views.SessionReport	testsession:session_report
/consumer/<int:api_id>/<uuid:uuid>/stop/	vng.testsession.views.StopSession	testsession:stop_session
/consumer/<int:api_id>/<uuid:uuid>/test-report-pdf/<int:pk>/	vng.testsession.views.SessionTestReportPDF	testsession:session-test_report-pdf
/consumer/<int:api_id>/<uuid:uuid>/test-report/<int:pk>/	vng.testsession.views.SessionTestReport	testsession:session-test_report
/consumer/<int:api_id>/<uuid:uuid>/update/	vng.testsession.views.SessionLogUpdateView	testsession:session_update
/consumer/<int:api_id>/create/	vng.testsession.views.SessionFormView	testsession:session_create
/consumer/<int:api_id>/postman/<int:pk>/	vng.testsession.views.PostmanDownloadView	testsession:postman_download
/consumer/<int:api_id>/sessiontype/<int:pk>/	vng.testsession.views.SessionTypeDetail	testsession:session_type-detail
/design_rules/	vng.design_rules.views.DesignRulesListView	design_rules:list
/design_rules/<uuid:uuid>/	vng.design_rules.views.DesignRulesDetailView	design_rules:detail
/design_rules/<uuid:uuid>/create/	vng.design_rules.views.DesignRuleSessionCreateView	design_rules:session_create
/design_rules/<uuid:uuid_test_suite>/<uuid:uuid>/	vng.design_rules.views.DesignRuleSessionDetailView	design_rules:session_detail
/design_rules/<uuid:uuid_test_suite>/<uuid:uuid>/shield/	vng.design_rules.views.DesignRuleShieldDetailView	design_rules:session_shield
/design_rules/create/	vng.design_rules.views.DesignRulesCreateView	design_rules:create
/i18n/setlang/	django.views.i18n.set_language	set_language
/pages/<path:url>	django.contrib.flatpages.views.flatpage	django.contrib.flatpages.views.flatpage
/reset/<uidb64>/<token>/	django.contrib.auth.views.PasswordResetConfirmView	password_reset_confirm
/reset/done/	django.contrib.auth.views.PasswordResetCompleteView	password_reset_complete
/server/<int:api_id>/	vng.servervalidation.views.EnvironmentList	server_run:environment_list
/server/<int:api_id>/<int:server_id>/stop/	vng.servervalidation.views.StopServer	server_run:server-run_stop
/server/<int:api_id>/<int:test_id>/<int:env_id>/create/endpoints	vng.servervalidation.views.CreateEndpoint	server_run:endpoints_create
/server/<int:api_id>/<int:test_id>/<int:env_id>/update/endpoints	vng.servervalidation.views.UpdateEndpointView	server_run:endpoints_update
/server/<int:api_id>/<int:test_id>/create/	vng.servervalidation.views.SelectEnvironment	server_run:server-run_select_environment
/server/<int:api_id>/<uuid:scenario_uuid>/<uuid:env_uuid>/	vng.servervalidation.views.ServerRunList	server_run:server-run_list
/server/<int:api_id>/<uuid:scenario_uuid>/<uuid:env_uuid>/latest/	vng.servervalidation.views.LatestRunView	server_run:server-run_latest
/server/<int:api_id>/<uuid:scenario_uuid>/<uuid:env_uuid>/update/	vng.servervalidation.views.EnvironmentInfoUpdate	server_run:environment_info-update
/server/<int:api_id>/<uuid:uuid>/	vng.servervalidation.views.ServerRunOutputUuid	server_run:server-run_detail
/server/<int:api_id>/<uuid:uuid>/log/<int:test_result_pk>/	vng.servervalidation.views.ServerRunLogView	server_run:server-run_detail_log
/server/<int:api_id>/<uuid:uuid>/log_json/<int:test_result_pk>/	vng.servervalidation.views.ServerRunLogJsonView	server_run:server-run_detail_log_json
/server/<int:api_id>/<uuid:uuid>/pdf/<int:test_result_pk>	vng.servervalidation.views.ServerRunPdfView	server_run:server-run_detail_pdf
/server/<int:api_id>/<uuid:uuid>/schedule/	vng.servervalidation.views.CreateSchedule	server_run:server-run_create_schedule
/server/<int:api_id>/<uuid:uuid>/schedule/activate/	vng.servervalidation.views.ScheduleActivate	server_run:schedule_activate
/server/<int:api_id>/<uuid:uuid>/trigger/	vng.servervalidation.views.TriggerServerRun	server_run:server-run_trigger
/server/<int:api_id>/<uuid:uuid>/update/	vng.servervalidation.views.ServerRunOutputUpdate	server_run:server-run_info-update
/server/<int:api_id>/create/	vng.servervalidation.views.ServerRunForm	server_run:server-run_create_item
/server/<int:api_id>/postman/<int:pk>/	vng.servervalidation.views.PostmanDownloadView	server_run:postman_download
/server/<int:api_id>/scenario/create/	vng.servervalidation.views.CreateTestScenarioView	server_run:test-scenario_create_item
/server/<int:api_id>/testscenario/<int:pk>/	vng.servervalidation.views.TestScenarioDetail	server_run:testscenario-detail
/server/<int:api_id>/testscenario/<uuid:scenario_uuid>/delete	vng.servervalidation.views.TestScenarioDeleteView	server_run:testscenario-delete
/server/<int:api_id>/testscenario/<uuid:scenario_uuid>/update	vng.servervalidation.views.TestScenarioUpdateView	server_run:testscenario-update
/server/<int:api_id>/testscenarios/	vng.servervalidation.views.TestScenarioList	server_run:test-scenario_list
/server/generate/	vng.servervalidation.views.CollectionFromOASView	server_run:collection_generator
